::::::::::::::‡‡::::::||..::::||..::::::::::::||..........‡‡..##......##..............::::::::::::::::‡‡::||..::::||..##......::
==‡‡::‡‡::::::‡‡======‡‡======‡‡##‡‡==========‡‡..##########..##..####################‡‡==‡‡::‡‡::‡‡==‡‡::||##‡‡::||..##‡‡‡‡..‡‡
..##::::::‡‡::::::::::::::::::||......##......##..............##..........##......##......##::||::||....::||..##::||..::::||....
..##‡‡====‡‡======‡‡::‡‡==‡‡==‡‡..##..##..##..##########################..######..##..##..##::||::‡‡======‡‡..##::‡‡::‡‡::‡‡==‡‡
..........##......##::::::||......##......##..##......##..............##..............##..##::||::::::::::||....::::::||::::::||
########..##..##..##‡‡‡‡::||..##################..##..##..##################..##########..##::||::‡‡==‡‡::‡‡==========‡‡==‡‡::||
..........##..##........::||......##..............##..##..##......##......##..........‡‡....::||::::::||::::::::::::::::::||::||
########..##############‡‡‡‡####..##########..######..##..##..##..##..##..########‡‡::‡‡==‡‡==‡‡======‡‡==‡‡::‡‡======‡‡::||::‡‡
......##..##..................##..........##..##......##......##......##..........::::::::||..::::::::||....::||......##::||::::
####..##..##..##############..##########..##..######################..######..####‡‡::::::‡‡::‡‡==‡‡::||..##‡‡‡‡####..##::‡‡==‡‡
......##..##..##......##..##..........##..............##..........##......##......||::::::::::::::||::||..##......##..##::||....
..######..##..##..##..##..##########..##########..######..##..##################..||::::::::‡‡‡‡::||::||..##..##..##..##::‡‡==‡‡
......##..‡‡..##..##......##......##..##......##..##......##..........##......##..||::::::‡‡::::::||::||......##......##::::::||
####..##::||..##..##########..##..##..##..##..##..##..##..##########..##..##..##..‡‡======‡‡::‡‡==‡‡::||####‡‡‡‡####..##‡‡‡‡::||
......::::||..##......######..##..........##..##..##..##......##..##......##..##..##......##::::::||::||..::::||......######::||
####::‡‡==‡‡..##..##..######..##############..##..##########..##..######‡‡‡‡..##..##..######‡‡‡‡::||::‡‡::‡‡::||..##########::||
..::::||..........##..##......##..........##......##......##......##..::::||..‡‡......##..::::::::||::::::||::||..##........::||
::‡‡==‡‡..##########..##..######..##..##..##########..##..##########::‡‡::‡‡::||########::‡‡::‡‡==‡‡::‡‡==‡‡::||..####‡‡======‡‡
::::::||..##......##..##..........##..##..............##......##..::::||::::::||......::::||::::::||::||....::||......||::::::::
‡‡‡‡::||..##..######..##########..##########################..‡‡::‡‡==‡‡======‡‡==‡‡::‡‡==‡‡==‡‡::||::||..##‡‡‡‡####..‡‡::::::::
::||::||..‡‡......##......##..##..##......##..............##..||::::::::::::::::::::::||........::||::||..........##..::::::::::
::||::‡‡::||####..######..##..##..##..##..##..##########..##..||::::::::::::::‡‡======‡‡########‡‡‡‡::‡‡======‡‡..####‡‡::‡‡::‡‡
::||::::::||......##......##......##..##..##......##..........||::::::::::::::||..........##......##::::::::::||......##::::::||
::‡‡======‡‡..######..##############..##..######..##..######‡‡‡‡::::::::::::::||..######..##..##..##‡‡====‡‡::||########‡‡====‡‡
::||......##......##..######......##..##..........##..‡‡..::::::::::::::::::::||..‡‡..##......##..##..##....::||..........##..::
==‡‡..##..######..##..######..######..##############::‡‡::‡‡==‡‡::::::::::::‡‡‡‡::||..##########..##..##..##‡‡‡‡..######..##..‡‡
......##......##......######......##..##......##..::::::::::::::::::::::::::::::::||..........##..##......##......##......##....
############..######..##########..##..##..######..‡‡::::::::::::::::::::::‡‡======‡‡########..##..##################..##########
..##..........##......##..........##..##..........||::::::::::::::::::::::||..............##..##..................##............
..##..######..##..######..##########..############‡‡::::::::::::::::::::::||..##..######..##..##################..##############
..##......##..##......##..##......##..........##..::::::::::::::::::::::::||..##..##......##......##..........##..######........
############..######..##..##..##..##########..####‡‡::::::::::::::::::::::||..##..##############..##..######..##..######..######
..............##......##..##..##..##......##......||::::::::::::::::::::::||..‡‡..............##..##......##......##......##....
########################..##..######..##..######..||::::::::::::::::::::::‡‡::‡‡==‡‡####..##..##..######..######..##..######..##
......##..............##..............##..##......||::::::::::::::::::::::::::::::||......##..##......##......‡‡..##............
########..##########..##########..######..######..||::::::::::::::::::::::::::::::||..##############..##..‡‡::‡‡==========‡‡####
......‡‡..‡‡......##..........##......##..........||::::::::::::::::::::::‡‡::::::||..........##......##..||::::::::::::::||....
==‡‡::‡‡::||..##..######‡‡‡‡..##..##..##########..‡‡::‡‡==========‡‡::‡‡==‡‡::::::||########..##..########‡‡::::::::::::::‡‡====
::::::::::||..##..‡‡..::::||......##..‡‡......##..##::||..::::::::||::||..::::::::||......##..##..........::::::::::::::::::::::
::::‡‡‡‡==‡‡==‡‡::‡‡::‡‡::‡‡======‡‡::||..##..##..##::‡‡==‡‡::::::||::‡‡::‡‡::::::||..##..##..############‡‡======‡‡::::‡‡‡‡::::
::‡‡::||..::::::::::::||::::::::::::::||..##......##::::::::::::::||::::::||::::::||..##..........................‡‡::‡‡::::::::
::||::‡‡::‡‡::‡‡==‡‡::‡‡======‡‡======‡‡..##..######‡‡====‡‡::::::‡‡======‡‡::::‡‡‡‡======‡‡..######################::||::‡‡==‡‡
::||::::::||::::::||::::::::::||..........##......##......||::::::::::::::||::::::::::::::||..............##..##....::||::||..::
==‡‡======‡‡==‡‡::‡‡======‡‡==‡‡..##############..##..##..||::::::‡‡==‡‡::‡‡==‡‡::‡‡==‡‡::||########..##..##..##..##‡‡‡‡==‡‡..‡‡
..............##::||::::::||......##..........##..##..##..||::::::::::||::::::||::||####::||..........##......##..............##
..##########..##::‡‡::::::||..##############..##..##..##..‡‡==========‡‡==‡‡::||::‡‡==‡‡::||..##################################
..##..##......##::::::::::||..##..........##......##..##..::::::::::::::::||::||::::::||::||..##..............##..##............
####..##..######‡‡‡‡::::::||..##..##..##############..####‡‡::::::‡‡::‡‡::||::‡‡==‡‡::||::||..##############..##..##..######..##
..##..##..##......::::::::||......##..........######..##..||::::::||::||::||::||....::||::||..........##......##......##........
####..##..######..‡‡::‡‡==‡‡############..##..######..##..||::::::‡‡==‡‡::||::||####‡‡‡‡::||..######..##..##..##########..######
......##..##......##::::::||..........‡‡..##..........##..||::::::::::::::||::||........::||......##......##..##......##..##..##
..######..##..######‡‡‡‡::‡‡======‡‡::||..##############..‡‡======‡‡::‡‡::||::||..######‡‡‡‡####..##..######..######..##..##..##
..##......##......##....::::::::::::::||..##..............##........::||::||::||......##......##..##......##..........##......##
..##..##############..##‡‡============‡‡..##..##############..######‡‡‡‡==‡‡::||####..######..##..######..######################
..##..................##..............##......##..........##......##......##::||..##......##..##......##..............‡‡........
########################..##########..##..######..######..######..##..##..##::||..######..##..######..##########‡‡‡‡::||..######
......##..............##..##########..##......##......##......##..##..##....::||..##......##..........######..::::::::||........
####..##..##########..##..##########..######..######..##########..##..######‡‡‡‡..##..####‡‡==========‡‡####::‡‡======‡‡..######
......##..........‡‡......##..............##..##..................##......‡‡......##......||::::::::::||..::::||..........##....
########‡‡‡‡####::||####‡‡‡‡..##########..######..######‡‡============‡‡::||..##########..||::::::::::‡‡::‡‡==‡‡####..##########
..‡‡..::::||..::::||..::::||..........##..........##..::::::::::::::::::::||..##..........||::::::::::::::||......##..........::
::‡‡::‡‡::‡‡::‡‡==‡‡::‡‡::||####‡‡‡‡..######‡‡====‡‡::‡‡::‡‡==============‡‡..########‡‡::‡‡::‡‡==‡‡::‡‡==‡‡==‡‡..##..########‡‡
::::::::::::::::::::::||::||..::::||..##..::::::::::::||::||..........##......##......::::::::::::::::::::::::||......##......||
::::::::::::::::::‡‡==‡‡::‡‡::‡‡::‡‡==‡‡::‡‡==‡‡======‡‡::||..######..##..######..####‡‡::::::::::::::::::‡‡::‡‡==‡‡####..####‡‡