+--+--+--+--+--+--+--+--+--+--+--+--+--+--+--+--+--+--+--+--+--+--+--+--+--+--+--+--+--+--+
|           |                                         |                             |     |
+           +           +--+--+              +        +  +--+                 +--+--+     +
|           |           |     |              |        |  |                    |           |
+           +        +--+     +--+--+--+     +--+--+--+  +        +           +           +
|           |        |        |                 |        |        |           |           |
+           +--+     +  +     +                 +  +--+--+--+--+  +--+--+--+--+     +--+  +
|              |     |  |                       |  |           |                    |     |
+              +  +--+  +        +--+--+--+  +--+  +        +--+--+--+--+--+     +--+     +
|                 |     |           |     |  |     |                 |     |     |        |
+        +        +  +--+           +     +--+  +--+                 +     +     +        +
|        |        |  |              |           |                    |     |     |        |
+        +     +--+  +--+--+--+     +  +--+--+--+--+--+--+           +     +--+--+--+--+  +
|        |     |     |        |     |  |                             |                 |  |
+        +--+--+     +        +  +--+  +                       +     +           +--+--+  +
|              |     |        |  |     |                       |     |           |        |
+     +--+--+--+     +     +  +--+  +--+           +--+--+--+--+     +        +--+        +
|     |     |        |     |        |                    |           |        |           |
+--+--+     +        +--+  +--+--+--+--+--+--+           +           +--+     +           +
|           |           |  |                             |                    |           |
+           +--+        +  +                 +--+--+--+--+     +--+--+     +--+  +  +--+--+
|              |        |  |                 |        |        |     |     |     |  |     |
+        +     +        +  +--+        +     +  +--+  +--+     +     +--+  +     +--+     +
|        |     |        |     |        |     |  |  |     |     |        |  |              |
+        +     +        +--+  +  +     +  +--+  +  +--+  +--+  +        +--+--+--+        +
|        |                 |  |  |     |  |     |     |     |  |           |              |
+        +--+--+--+        +  +--+  +--+--+  +--+     +--+  +--+     +     +              +
|        |        |        |        |        |           |           |     |              |
+        +        +  +--+--+  +--+--+        +           +           +     +        +     +
|                 |  |        |              |           |           |     |        |     |
+     +--+--+  +--+  +     +--+        +--+--+--+        +        +--+  +--+--+     +     +
|     |     |  |     |     |           |        |                 |                 |     |
+  +--+     +  +     +     +  +        +        +--+           +--+                 +     +
|           |  |     |     |  |        |           |           |  |                 |     |
+           +  +--+--+     +  +--+--+--+     +--+  +--+  +--+--+  +--+           +--+  +--+
|           |              |                 |  |     |  |        |  |           |        |
+--+        +              +              +--+  +--+  +--+  +--+--+  +     +--+--+        +
|           |              |                       |        |        |     |              |
+           +--+--+--+--+--+                       +--+     +        +--+--+              +
|                          |                          |     |                             |
+--+--+--+--+--+--+--+--+--+--+--+--+--+--+--+--+--+--+--+--+--+--+--+--+--+--+--+--+--+--+